0 0 0 0 0 -1
-166.65582 39.72762 87.9822 1.2984415 -0.17859912
11
0 25 0 -50 25 0 -100 15 3.1 1 0.3 0 0 1
1 -25 0 -50 25 0 -50 15 4.7 1.5 0.11 0.08 0 6
2 13 0 0 10 0 0 20 1 1 0 0 0 0
3 -15 0 0 -15 0 30 20 0.3 0.8 0 0.25 0 0
4 15 0 0 15 0 30 20 0.3 0.8 0 0.25 0 0
5 15 0 30 80 0 30 40 5 1 0 0 0 0
6 -15 0 30 -80 0 30 40 5 1 0 0 0 0
7 -15 20 30 15 20 30 20 2.3 0.5 0.38 0 0 0
8 55 0 30 55 0 70 12 2.8 0.3 0.05 9 0 0
9 55 0 70 80 0 70 12 2 0.3 2 9 0 0
10 80 0 30 80 0 260 31 10 0.77 1 0.3 0 0
8
1000 -80 0 0 80 0 0 80 0 90 1 1 0 0 0 1 2
1001 -25 0 -50 25 0 -100 -25 0 -100 1 1 0 0 0 1 4
1002 -25 15 -50 25 15 -50 25 15 -100 1 1 0 0 0 1 7
1003 -25 15 -50 25 15 -100 -25 15 -100 1 1 0 0 0 1 7
1004 -80 0 0 -81 0 90 80 0 90 1 1 0 0 0 1 2
1005 90 41 30 80 31 260 80 31 30 1 1 0 0 90 1 3
1006 55 12 30 55 12 70 80 19 30 1 1 0 0 90 1 3
1007 80 19 30 80 19 70 55 12 70 1 1 0 0 90 1 3
