0 0 0 0 0 -1
-75.0103 24.110352 233.7517 0.541129 -0.09359915
22
0 25 0 -50 25 0 -100 15 3.1 1 0.3 0 0 1
1 -25 0 -50 25 0 -50 15 4.7 1.5 0.11 0.08 0 6
2 13 0 0 10 0 0 20 1 1 0 0 0 0
3 15 0 30.01 -15 0 30.1 20 1 1 0.995 0 0 5
4 15 0 0 15 0 30 20 0.3 0.8 0 0.25 0 0
5 15 0 -36 90 0 30 40 5.8 1 0 0 0 0
6 90 0 30 -90 0 30 40 12.8 1 3.487 0 0 0
7 -15 20 -48 15 20 30 20 2.3 0.5 0.38 0 0 0
8 55 0 30 55 0 70 12 2.8 0.3 0.05 9 0 0
9 55 0 70 80 0 70 12 2 0.3 2 9 0 0
10 80 0 30 80 0 260 31 10 0.77 1 0.3 0 0
11 -80 0 30 -80 0 260 31 10 0.77 1 0.3 0 0
12 -55 0 30 -55 0 70 12 2.8 0.3 0.05 9 0 0
13 -80 0 70 -55 0 70 12 2 0.3 2 9 0 0
14 -90 40 20 -90 40 260 6 9.7 1 3.3 0 0 4
15 90 40 20 90 40 260 6 9.7 1 3.3 0 0 4
16 -90 10 260 -60 10 260 45 1 1 0 0 0 0
17 -60 10 260 -25 10 260 30 1 1 0 0 0 0
18 25 10 260 91 10 260 30 1 1 0 0 0 0
19 25 10 276 25 10 260 30 1 1 0 0 0 0
20 -25 10 260 -25 10 280 30 1 1 0 0 0 0
21 -25 10 280 25 10 276 15 1 1 0 0 0 0
23
1000 -80 0 0 80 0 0 80 0 90 1 1 0 0 0 1 2
1001 -25 0 -50 25 0 -100 -25 0 -100 1 1 0 0 0 1 4
1002 -25 15 -50 25 15 -50 25 15 -100 1 1 0 0 0 1 7
1003 -25 15 -50 25 15 -100 -25 15 -100 1 1 0 0 0 1 7
1004 -80 0 0 -81 0 90 80 0 90 1 1 0 0 0 1 2
1005 90 40 30 80 31 260 80 31 30 1 1 0 0 90 1 3
1006 55 12 30 55 12 70 80 19 30 1 1 0 0 90 1 3
1007 80 19 30 80 19 67 55 12 70 1 1 0 0 90 1 3
1008 90 40 30 90 40 260 80 31 260 1 1 0 0 90 1 3
1009 -80 31 30 -80 31 260 -90 41 30 1 1 0 0 90 1 3
1010 -80 31 260 -90 41 260 -90 41 30 1 1 0 0 90 1 3
1011 90 46 20 90 40 30 -90 40 30 1 1 0 0 0 1 3
1012 -90 46 20 90 46 20 -90 40 30 1 1 0 0 0 1 3
1013 55 12 70 80 19 67 80 12 70 1.24 2.5 0 0 0 1 3
1014 80 9 220 80 0 90 65 0 90 1 1 0 0 0 1 2
1015 -55 12 30 -55 12 70 -80 19 30 1 1 0 0 90 1 3
1016 -80 19 30 -80 19 67 -55 12 70 1 1 0 0 90 1 3
1017 -80 19 67 -55 12 70 -80 12 70 1.24 2.5 0 0 0 1 3
1018 65 9 220 65 0 90 80 9 220 1 1 0 0 0 1 2
1019 24 9 237 25 15 260 80 15 260 1 1 0 0 0 1 1
1020 24 9 237 80 15 260 80 9 237 1 1 0 0 0 1 1
1021 -80 9 237 80 9 220 80 9 237 1 1 0 0 0 1 2
1022 -80 9 237 80 9 220 -80 9 220 1 1 0 0 0 1 2
1
0 5 5 -5